性格不合	性格不合
家庭琐事	生活家庭琐事
无法沟通	缺少交流
不履行夫妻义务	不履行家庭义务
开始分居	婚姻生活不和谐
分居至今	长期分居
分居两地	长期分居
交流频少	缺少交流
缺乏一定的沟通	缺少交流
网络认识	性格不合
婚前感情基础薄弱	婚前缺乏了解
婚前感情薄弱	婚前缺乏了解
家庭生活琐事	生活家庭琐事
婚前缺乏了解	婚前缺乏了解
草率结婚	婚前缺乏了解
性格相差太远	性格不合
性格差异大	性格不合
违法犯罪行为	违法犯罪行为
婚前了解甚少	婚前缺乏了解
生活作风不好	生活家庭琐事
生活琐事	生活家庭琐事
无法正常生活	无法正常生活
家庭暴力行为	家庭暴力
分居生活	长期分居
家务琐事	生活家庭琐事
分居生活至今	长期分居
互不履行夫妻义务	婚姻生活不和谐
常发生纠纷	生活家庭琐事
分居一年	长期分居
经常离家不归	离家出走
不务正业	不务正业
判处有期徒刑	违法犯罪行为
服刑	违法犯罪行为
性格不投	性格不合
生活家务琐事	生活家庭琐事
长期分居	长期分居
被告家暴	家庭暴力
经常离家出走	离家出走
分居两年	长期分居
至今未归	离家出走
至今不回	离家出走
被告回娘家	离家出走
被告回到娘家	离家出走
婚前相识时间较短	婚前缺乏了解
婚前了解不够	婚前缺乏了解
经常赌博	赌博
实施家庭暴力	家庭暴力
父母过多干涉	父母干涉
酗酒恶习	酗酒
酒后殴打	家庭暴力
至今下落不明	下落不明
婚前缺乏必要的相互了解	婚前缺乏了解
殴打原告	家庭暴力
双方分居	双方分居
不知去向	下落不明
游手好闲	不务正业
多次对原告打骂	家庭暴力
多次闹过离婚	多次闹过离婚
分居生活自今	长期分居
拳脚相加	家庭暴力
经常赌博	赌博
分居4年	长期分居
分居两年	长期分居
离家外出	离家出走
虐待遗弃家庭成员	虐待遗弃家庭成员
不务正业	不务正业
重婚	重婚
性格不合	性格不合
性格不搭	性格不合
家暴	家庭暴力
经济压力	经济压力
离家出走	离家出走
违法犯罪	违法犯罪行为
犯罪	违法犯罪行为
坐牢	违法犯罪行为
服刑	违法犯罪行为
酗酒	酗酒
酒后殴打	家庭暴力
殴打	家庭暴力
醉酒殴打	家庭暴力
包办婚姻	包办买卖婚姻
买卖婚姻	包办买卖婚姻
包办买卖婚姻	包办买卖婚姻
生理缺陷	生理缺陷
长期分居	长期分居
婆媳关系不和	婆媳关系不合
婆媳关系不合	婆媳关系不合
草率结婚	草率结婚
婚前缺乏了解	婚前缺乏了解
婚前缺乏必要的了解	婚前缺乏了解
无法生育	无法生育小孩
不能生小孩	无法生育小孩
与婚前预期不符	与婚前预期不符
与婚前预期严重不符	与婚前预期严重不符
婚姻生活不和谐	婚姻生活不和谐
患有精神病	患有精神病
患有疾病	生理缺陷
下落不明	下落不明
房产证纠纷	房产证纠纷
房产纠纷	房产证纠纷
经常吵架	婚姻生活不和谐
生活琐事	生活家庭琐事
家庭琐事	生活家庭琐事
生活家庭琐事	生活家庭琐事
不履行家庭义务	不履行家庭义务
不对家庭负责	不负责任
缺乏交流	缺少交流
缺少交流	缺少交流
无法沟通	无法沟通
无法交流	无法沟通
骗婚	骗婚
冷暴力	冷暴力
拳打脚踢	家庭暴力
重婚	重婚
生活习惯不同	生活习惯不同
结婚后未同居生活	结婚后未同居生活
突发家庭重大事件	突发家庭重大事件
婚外情	婚外情
小三	婚外情
暧昧	婚外情
第三者 婚外情
情人 婚外情
外遇 婚外情
出轨  婚外情
包养  婚外情
不正当关系	婚外情
经济压力大	经济压力
生活压力大	生活压力
好赌	赌博
嗜赌	赌博
嗜酒	酗酒
无法相处	无法相处
婚姻观念转变	婚姻观念转变
心理年龄低下	心理年龄低下
打了我	家庭暴力